Sesli asistanımızın ismi çirkin'dir uygulamak istediğiniz fonksiyondan önüne "çirkin" kelimesini eklemeniz ve öyle söylemeniz gerekmektedir.(örneğin:çirkin netflix veya çirkin saat kaç)
25 farklı fonksiyona sahipti.
Fonksiyonlar: 
-merhaba =size merhabaya karşılık gelen cevapları verir
-nasılsın =size nasılsına karşılık gelen cevapları verir
-teşekkürler =size teşekkürlere karşılık gelen cevapları verir
-youtube = webdriver üzerinden youtube'u açar
-youtube'da aç = size youtube'da ne açmak istediğinizi sorar ve cevabınızı web driver üzerinden açar
-netflix =netflix uygulamasını açar
-saat kaç = saati size söyler
-disney =disney uygulamasını açar
-discord =discord uygulamasını açar
-hesap makinesi =netflix uygulamasını açar
-not defteri = not defteri uygulamasını açar
-whatsapp =whatsapp uygulamasını açar
-bilgisayarda aç =size hangi uygulamayı istediğinizi sorar ve uygulamayı açar
-google =webdriver kullanarak google'ı açar
-araştır = ne araştırmak istediğinizi sorar ve google üzerinden araştırır
-not al = sözlerinizi dosyada bulunan not.txt dosyasına kaydeder
-not oku =  not.txt dosyasını okur
-not sil = not.txt dosyasında bulunan notlarınızı siler.
-ses azalt = 5 sesi azaltır
-ses arttır = 5 sesi arttırır
-foto çek =kamera uygulamasını açarak fotoğrafınızı çekmeyi sağlar
-çek = tekrar fotoğraf çekmek istediğinizde bu özellik ile tekrar fotoğrafınızı çekersiniz
-dolar kuru = Beautiful Soup kullanarak dolar kurunu anlık çeker ve söyler
-euro kuru  = Beautiful Soup kullanarak euro kurunu anlık çeker ve söyler
-kapat = kendini kapatır.

şeklindedir.

notlar: 
-uygulama açma işlemini PyAutoGUI kullanarak yapar (discord hariç! örnek olması için os kullanarak discordu benim dizinime göre açmaktadır.). Sebebi dosya uzantısını değiştirme zahmetinden kurtulmak için
-arka planda süresiz çalışıp istenildiği gibi kullanılması için (siri gibi) emrinizden önce çirkin eklemeniz gerekmektedir. İsmini siz değişebilirsiniz .


 
